##############
#xxx# *   o  #
###x#   #    #
#   ### #         #
# ###   #  * #
#   #  c#    #
#  *# # o    #
#     #@o     #
#   o # o    #
##############